10  10  10  10  10  10  10  10  10  10  10  10  10  10  10  10  10  10  10  10  10  10  10  10  10  10  10  10  10  10  10  10  10  10  10  10  10  10  10  10  10  10  10  10  10  10  10  10  10  10  10  10
10  17  0  0  0  0  0  0  0  0  0  0  0  0  0  0  0  0  0  0  0  0  0  0  0  0  0  0  0  0  0  0  0  0  0  0  0  0  0  0  0  0  0  0  0  0  0  0  0  0  17  10
10  0  0  0  7  6  6  6  6  6  6  6  6  6  6  6  6  12  6  12  6  6  6  6  6  6  6  6  6  6  6  6  12  6  12  6  6  6  6  6  6  6  6  6  6  0  6  9  0  0  0  10
10  0  0  0  8  5  5  5  5  5  5  5  5  5  5  5  5  2  0  8  5  5  5  5  5  5  5  5  5  5  5  5  8  0  2  5  5  5  5  5  5  5  5  5  5  5  5  2  0  0  0  10
10  0  0  0  8  5  5  5  5  5  5  5  5  5  5  5  5  2  0  8  5  5  5  5  5  5  5  5  5  5  5  5  8  0  2  5  5  5  5  5  5  5  5  5  5  5  5  2  0  0  0  10
10  13  0  0  8  5  5  5  5  5  5  5  5  5  5  5  5  2  0  8  5  5  5  5  5  5  5  5  5  5  5  5  8  0  2  5  5  5  5  5  5  5  5  5  5  5  5  2  0  0  13  10
10  0  0  0  8  5  5  5  5  5  5  5  5  5  5  5  5  2  0  8  5  5  5  5  5  5  5  5  5  5  5  5  8  0  2  5  5  5  5  5  5  5  5  5  5  5  5  2  0  0  0  10
10  0  0  0  16  6  12  6  12  6  12  6  12  6  6  12  6  15  6  15  4  12  4  12  4  12  4  12  4  4  12  4  15  4  15  6  12  6  12  6  12  6  12  6  6  12  6  14  0  0  0  10
10  0  0  0  8  0  2  0  8  0  2  0  8  0  0  2  0  8  0  2  0  8  0  2  0  8  0  2  0  0  8  0  2  0  0  0  2  0  8  0  2  0  8  0  0  2  0  2  0  0  0  10
10  0  0  0  16  4  18  4  18  4  18  4  18  4  4  18  4  18  4  18  6  18  6  15  6  15  6  18  6  6  18  6  18  6  18  4  18  4  15  4  15  4  18  4  4  18  4  14  0  0  0  10
10  0  0  0  8  0  0  0  2  0  8  5  5  5  5  5  5  5  5  5  5  5  5  8  0  2  5  5  5  5  5  5  5  5  5  5  5  5  8  0  2  5  5  5  5  5  5  2  0  0  0  10
10  0  0  0  8  0  0  0  2  0  8  5  5  5  5  5  5  5  5  5  5  5  5  8  0  2  5  5  5  5  5  5  5  5  5  5  5  5  8  0  2  5  5  5  5  5  5  2  0  0  0  10
10  0  0  0  8  0  0  0  0  6  0  5  5  5  5  5  5  5  5  5  5  5  5  16  4  14  5  5  5  5  5  5  5  5  5  5  5  5  16  4  14  5  5  5  5  5  5  2  0  0  0  10
10  11  6  6  0  0  0  0  8  0  2  5  5  5  5  5  5  5  5  5  5  5  5  2  0  8  5  5  5  5  5  5  5  5  5  5  5  5  2  0  8  5  5  5  5  5  5  0  6  6  11  10
10  11  6  6  0  0  0  0  8  0  2  5  5  5  5  5  5  5  5  5  5  5  5  2  0  8  5  5  5  5  5  5  5  5  5  5  5  5  2  0  8  5  5  5  5  5  5  0  6  6  11  10
10  0  0  0  2  0  0  0  0  4  0  5  5  5  5  5  5  5  5  5  5  5  5  16  6  14  5  5  5  5  5  5  5  5  5  5  5  5  16  6  14  5  5  5  5  5  5  8  0  0  0  10
10  0  0  0  2  0  0  0  2  0  8  5  5  5  5  5  5  5  5  5  5  5  5  8  0  2  5  5  5  5  5  5  5  5  5  5  5  5  8  0  2  5  5  5  5  5  5  8  0  0  0  10
10  0  0  0  2  0  0  0  2  0  8  5  5  5  5  5  5  5  5  5  5  5  5  8  0  2  5  5  5  5  5  5  5  5  5  5  5  5  8  0  2  5  5  5  5  5  5  8  0  0  0  10
10  0  0  0  16  6  12  6  15  6  15  6  12  6  6  12  6  12  6  12  4  12  4  15  4  15  4  12  4  4  12  4  12  4  12  6  12  6  15  6  15  6  12  6  6  12  6  14  0  0  0  10
10  0  0  0  2  0  8  0  2  0  8  0  2  0  0  8  0  2  0  8  0  2  0  8  0  2  0  8  0  0  2  0  8  0  2  0  8  0  2  0  8  0  2  0  0  8  0  8  0  0  0  10
10  0  0  0  16  4  18  4  18  4  18  4  18  4  4  18  4  15  4  15  6  18  6  18  6  18  6  18  6  6  18  6  15  6  15  4  18  4  18  4  18  4  18  4  4  18  4  14  0  0  0  10
10  13  0  0  2  5  5  5  5  5  5  5  5  5  5  5  5  8  0  2  5  5  5  5  5  5  5  5  5  5  5  5  2  0  8  5  5  5  5  5  5  5  5  5  5  5  5  8  0  0  13  10
10  0  0  0  2  5  5  5  5  5  5  5  5  5  5  5  5  8  0  2  5  5  5  5  5  5  5  5  5  5  5  5  2  0  8  5  5  5  5  5  5  5  5  5  5  5  5  8  0  0  0  10
10  0  0  0  2  5  5  5  5  5  5  5  5  5  5  5  5  8  0  2  5  5  5  5  5  5  5  5  5  5  5  5  2  0  8  5  5  5  5  5  5  5  5  5  5  5  5  8  0  0  0  10
10  0  0  0  2  5  5  5  5  5  5  5  5  5  5  5  5  8  0  2  5  5  5  5  5  5  5  5  5  5  5  5  2  0  8  5  5  5  5  5  5  5  5  5  5  5  5  8  0  0  0  10
10  0  0  0  1  6  6  6  6  6  6  6  6  6  6  6  6  18  6  18  6  6  6  6  6  6  6  6  6  6  6  6  18  6  18  6  6  6  6  6  6  6  6  6  6  6  6  3  0  0  0  10
10  17  0  0  0  0  0  0  0  0  0  0  0  0  0  0  0  0  0  0  0  0  0  0  0  0  0  0  0  0  0  0  0  0  0  0  0  0  0  0  0  0  0  0  0  0  0  0  0  0  17  10
10  10  10  10  10  10  10  10  10  10  10  10  10  10  10  10  10  10  10  10  10  10  10  10  10  10  10  10  10  10  10  10  10  10  10  10  10  10  10  10  10  10  10  10  10  10  10  10  10  10  10  10
